####################
#                  #
#                  #
#      ######      #
#                  #
#                  #
#                  #
#      #    #      #
#      #    #      #
#      #    #      #
####################