#####################
#   #   #           #
### # # ### ### #####
# # # #   # #   #   #
# # # ### # # ### # #
# # # # # # #     # #
# # # # # ####### # #
# #   #   #     # # #
# ##### ### ### ### #
#     # # #   #     #
# ##### # # # #######
# #   # #   #       #
# # # # ### ####### #
# # # #   # #       #
# # # ### ### ##### #
#   #   #   #     # #
####### ### ##### # #
#       #   #   # # #
# ####### ### # # # #
#             #   # #
#####################